2 13 31
###############################
#p *      *    * 2 *  * * *   #
# # # #*# # #*#*# # # #*#*#*# #
#**1*     * *  *  1   * 2 * * #
#*# #*# # #s# # #*#*# # # # #*#
#f *  *    1 *2  *  *   1     #
# # # # # # # # # #*# #*# # # #
#*  *  b   *  *      *     f  #
# # # # #*# # # #x#*# # # # # #
#*        *   2   *  *        #
# #*# # # # # # #*# # # # # # #
#     1      * *   *          #
###############################